Date,SuccessfulTests,FailedTests,ErrorTests,SkippedTests,TotalTests,PercentageOfSuccessfulTests
2019-05-04,0,0,0,0,0,-1.00
2019-06-02,0,0,0,0,0,-1.00
2019-07-04,138,1,0,0,139,99.28
2019-08-05,142,1,0,0,143,99.30
2019-09-05,144,0,0,0,144,100.00
2019-10-06,149,0,0,0,149,100.00
2019-11-04,158,3,0,0,161,98.14
2019-12-04,171,3,0,0,174,98.28
2020-01-06,172,3,0,0,175,98.29
2020-02-12,172,3,0,0,175,98.29
2020-03-22,195,5,0,0,200,97.50
2020-04-26,195,5,0,0,200,97.50
2020-05-26,211,5,0,0,216,97.69
2020-07-05,211,5,0,0,216,97.69
2020-08-19,211,5,0,0,216,97.69
2020-09-22,203,5,0,0,208,97.60
2021-01-28,203,5,0,0,208,97.60
2021-04-06,212,0,0,0,212,100.00
2021-05-23,212,0,0,0,212,100.00
2021-06-21,213,0,0,0,213,100.00
2021-10-13,213,0,0,0,213,100.00
2021-11-18,213,0,0,0,213,100.00
2022-03-08,213,0,0,0,213,100.00
2022-04-15,213,0,0,0,213,100.00
2022-05-24,213,0,0,0,213,100.00
2022-06-23,210,0,0,0,210,100.00
2022-08-30,210,0,0,0,210,100.00
2023-01-15,210,0,0,0,210,100.00
2023-02-21,210,0,0,0,210,100.00
2023-03-29,210,0,0,0,210,100.00
