Date,SuccessfulTests,FailedTests,ErrorTests,SkippedTests,TotalTests,PercentageOfSuccessfulTests
2018-03-11,0,0,0,0,0,-1.00
2018-04-09,0,0,0,0,0,-1.00
2018-05-13,0,0,0,0,0,-1.00
2018-06-22,0,0,0,0,0,-1.00
2018-07-22,0,0,0,0,0,-1.00
2018-08-22,0,0,0,0,0,-1.00
2018-10-02,0,0,0,0,0,-1.00
2018-11-04,38,2,0,0,40,95.00
2018-12-08,38,2,0,0,40,95.00
2019-01-06,42,2,0,0,44,95.45
2019-02-06,46,2,0,0,48,95.83
2019-03-11,40,2,0,0,42,95.24
2019-04-13,44,2,0,0,46,95.65
2019-05-12,44,2,0,0,46,95.65
2019-06-12,50,2,0,0,52,96.15
2019-07-13,52,2,0,0,54,96.30
2019-08-18,52,2,0,0,54,96.30
2019-09-22,52,2,0,0,54,96.30
2019-10-27,52,2,0,0,54,96.30
2019-12-15,52,2,0,0,54,96.30
2020-02-16,52,4,0,0,56,92.86
2020-05-02,52,4,0,0,56,92.86
2020-05-31,76,4,2,0,82,92.68
2020-07-19,84,4,2,0,90,93.33
2020-08-30,110,4,2,0,116,94.83
2020-10-13,118,4,2,0,124,95.16
2020-11-28,118,4,2,0,124,95.16
2021-01-04,120,4,2,0,126,95.24
2021-02-11,120,4,2,0,126,95.24
2021-03-14,120,4,2,0,126,95.24
2021-05-15,120,4,2,0,126,95.24
2021-10-17,120,4,2,0,126,95.24
2022-01-03,120,4,2,0,126,95.24
2022-02-02,120,4,2,0,126,95.24
2022-03-19,140,7,2,0,149,93.96
2022-06-24,142,7,2,0,151,94.04
2022-08-06,122,7,2,0,131,93.13
2022-09-10,122,7,2,0,131,93.13
2023-01-17,122,7,2,0,131,93.13
2023-04-01,124,7,2,0,133,93.23
