Date,SuccessfulTests,FailedTests,ErrorTests,SkippedTests,TotalTests,PercentageOfSuccessfulTests
2016-09-10,0,0,0,0,0,-1.00
2016-10-09,97,0,0,0,97,100.00
2016-11-07,363,0,0,1,364,99.73
2016-12-06,370,0,0,1,371,99.73
2017-01-05,380,0,0,1,381,99.74
2017-02-03,333,0,0,1,334,99.70
2017-03-04,337,0,0,1,338,99.70
2017-04-04,342,0,0,1,343,99.71
2017-05-03,344,0,0,1,345,99.71
2017-06-03,345,0,0,1,346,99.71
2017-07-03,346,0,0,1,347,99.71
2017-08-01,10,0,0,0,10,100.00
2017-08-30,363,0,2,1,366,99.18
2017-09-28,358,0,2,1,361,99.17
2017-10-28,351,0,2,1,354,99.15
2017-12-01,107,0,2,0,109,98.17
2017-12-30,364,0,2,1,367,99.18
2018-02-02,367,0,2,1,370,99.19
2018-03-03,368,0,2,1,371,99.19
2018-04-01,381,0,2,1,384,99.22
2018-05-05,383,0,2,1,386,99.22
2018-06-07,384,0,2,1,387,99.22
2018-07-06,414,0,2,5,421,98.34
2018-08-06,415,0,2,5,422,98.34
2018-09-04,420,0,2,5,427,98.36
2018-10-03,477,0,2,5,484,98.55
2018-11-02,477,0,2,5,484,98.55
2018-12-01,484,0,2,6,492,98.37
2018-12-30,491,0,2,8,501,98.00
2019-02-01,494,0,2,8,504,98.02
2019-03-02,524,7,2,8,541,96.86
2019-03-31,535,7,2,8,552,96.92
2019-04-29,566,2,2,16,586,96.59
2019-05-28,575,2,2,16,595,96.64
2019-07-02,592,3,10,18,623,95.02
2019-07-31,594,2,10,18,624,95.19
2019-08-29,601,2,14,20,637,94.35
2019-10-02,603,3,11,20,637,94.66
2019-11-01,603,3,11,20,637,94.66
2019-12-04,605,2,10,20,637,94.98
2020-01-31,606,2,10,20,638,94.98
2020-02-29,605,2,11,20,638,94.83
2020-03-31,609,2,10,20,641,95.01
2020-05-01,610,2,10,20,642,95.02
2020-05-30,612,3,10,20,645,94.88
2020-07-01,612,3,10,20,645,94.88
2020-07-30,627,2,10,20,659,95.14
2020-08-28,631,2,10,20,663,95.17
2020-09-30,633,2,10,20,665,95.19
2020-11-01,634,2,10,20,666,95.20
2020-11-30,645,2,10,20,677,95.27
2020-12-29,660,2,15,21,698,94.56
2021-01-27,669,2,15,21,707,94.63
2021-02-25,676,2,15,21,714,94.68
2021-03-28,676,2,15,21,714,94.68
2021-04-26,676,2,15,21,714,94.68
2021-05-25,677,2,15,25,719,94.16
2021-06-25,677,2,15,25,719,94.16
2021-07-26,680,2,15,27,724,93.92
2021-08-24,688,2,15,28,733,93.86
2021-09-22,688,2,15,28,733,93.86
2021-10-21,700,2,15,34,751,93.21
2021-11-22,703,2,16,34,755,93.11
2022-01-04,703,2,15,35,755,93.11
2022-02-02,706,2,15,35,758,93.14
2022-03-03,709,2,15,37,763,92.92
2022-04-03,738,2,15,31,786,93.89
2022-05-03,755,2,15,32,804,93.91
2022-06-01,755,2,15,36,808,93.44
2022-07-16,767,2,10,39,818,93.77
2022-08-16,762,2,10,52,826,92.25
2022-09-16,775,2,10,53,840,92.26
2022-10-15,779,2,10,56,847,91.97
2022-11-15,787,2,10,58,857,91.83
2022-12-14,791,2,10,59,862,91.76
2023-01-13,801,2,10,60,873,91.75
2023-02-11,812,2,10,60,884,91.86
2023-03-14,818,2,10,62,892,91.70
2023-04-12,823,2,12,63,900,91.44
