Date,SuccessfulTests,FailedTests,ErrorTests,SkippedTests,TotalTests,PercentageOfSuccessfulTests
2019-02-10,129,0,0,0,129,100.00
2019-03-11,211,2,0,3,216,97.69
2019-04-09,270,2,0,3,275,98.18
2019-05-08,285,0,1,9,295,96.61
2019-06-06,368,0,1,7,376,97.87
2019-07-05,426,1,0,7,434,98.16
2019-08-03,431,0,0,7,438,98.40
2019-09-02,435,0,0,7,442,98.42
2019-10-07,459,1,0,7,467,98.29
2019-11-05,659,3,0,7,669,98.51
2019-12-06,676,1,0,7,684,98.83
2020-01-06,709,1,0,7,717,98.88
2020-02-04,724,0,3,7,734,98.64
2020-03-04,791,0,0,7,798,99.12
2020-04-03,787,1,2,7,797,98.75
2020-05-02,807,1,2,21,831,97.11
2020-05-31,812,1,2,21,836,97.13
2020-06-29,819,1,2,23,845,96.92
2020-07-28,829,1,2,24,856,96.85
2020-08-28,830,2,2,24,858,96.74
2020-10-01,837,1,2,24,864,96.88
2020-10-30,874,3,2,24,903,96.79
2020-12-05,879,3,2,24,908,96.81
2021-01-04,910,0,0,24,934,97.43
2021-02-02,916,0,0,24,940,97.45
2021-03-04,936,1,0,24,961,97.40
2021-04-07,946,0,0,24,970,97.53
2021-05-06,955,1,0,24,980,97.45
2021-06-11,767,0,0,4,771,99.48
2021-07-12,770,0,0,4,774,99.48
2021-08-10,772,0,0,4,776,99.48
2021-09-08,889,0,5,3,897,99.11
2021-10-09,894,0,4,4,902,99.11
2021-11-11,894,0,4,4,902,99.11
2021-12-13,894,0,4,4,902,99.11
2022-01-11,896,0,4,4,904,99.12
2022-02-14,1009,1,4,21,1035,97.49
2022-03-16,1015,1,4,29,1049,96.76
2022-04-18,1019,1,0,29,1049,97.14
2022-05-17,1017,3,0,29,1049,96.95
2022-06-16,1018,3,0,29,1050,96.95
2022-07-15,1019,4,0,29,1052,96.86
2022-08-15,1020,3,0,29,1052,96.96
2022-09-13,1022,3,0,30,1055,96.87
2022-10-12,1022,3,0,30,1055,96.87
2022-11-13,1034,3,0,31,1068,96.82
2022-12-12,1037,3,0,33,1073,96.64
2023-01-10,1037,3,0,33,1073,96.64
2023-02-09,1054,4,3,33,1094,96.34
2023-03-11,1125,5,0,33,1163,96.73
2023-04-13,1125,5,0,33,1163,96.73
