Date,SuccessfulTests,FailedTests,ErrorTests,SkippedTests,TotalTests,PercentageOfSuccessfulTests
2018-07-23,43,0,8,0,51,84.31
2018-08-24,54,0,0,0,54,100.00
2018-09-25,95,0,0,1,96,98.96
2018-10-24,125,0,0,1,126,99.21
2018-11-23,145,0,0,2,147,98.64
2018-12-24,150,0,0,2,152,98.68
2019-01-25,178,0,0,2,180,98.89
2019-02-25,202,0,0,2,204,99.02
2019-03-26,246,0,0,2,248,99.19
2019-04-24,284,0,0,2,286,99.30
2019-05-23,293,0,0,2,295,99.32
2019-06-24,322,0,0,2,324,99.38
2019-07-23,330,0,0,2,332,99.40
2019-08-22,337,1,0,2,340,99.12
2019-09-20,341,1,0,2,344,99.13
2019-10-21,343,0,0,3,346,99.13
2019-11-20,350,0,0,3,353,99.15
2019-12-19,355,0,0,3,358,99.16
2020-01-19,362,0,0,3,365,99.18
2020-02-19,362,0,0,3,365,99.18
2020-03-19,393,2,0,3,398,98.74
2020-04-23,422,2,0,3,427,98.83
2020-05-25,866,4,0,6,876,98.86
2020-06-28,942,4,0,6,952,98.95
2020-08-03,486,2,0,3,491,98.98
2020-09-10,493,2,0,2,497,99.20
2020-10-29,501,2,0,2,505,99.21
2020-11-27,502,2,0,2,506,99.21
2020-12-28,503,2,0,2,507,99.21
2021-01-27,513,2,0,2,517,99.23
2021-02-25,513,2,0,2,517,99.23
2021-04-01,512,2,0,3,517,99.03
2021-05-17,512,2,0,3,517,99.03
2021-06-18,512,3,0,3,518,98.84
2021-07-27,514,2,0,3,519,99.04
2021-09-13,515,3,0,3,521,98.85
2021-11-19,517,2,0,3,522,99.04
2021-12-22,517,2,0,3,522,99.04
2022-01-20,517,2,0,3,522,99.04
2022-03-15,516,3,0,3,522,98.85
2022-04-25,483,2,0,3,488,98.98
2022-06-01,483,2,0,3,488,98.98
2022-07-09,483,2,0,3,488,98.98
2022-08-08,505,2,0,3,510,99.02
2022-09-15,506,2,0,3,511,99.02
2022-10-25,506,2,0,3,511,99.02
2022-11-25,514,2,0,3,519,99.04
2022-12-29,515,2,0,3,520,99.04
2023-02-03,514,3,0,3,520,98.85
2023-03-29,516,2,0,3,521,99.04
