Date,SuccessfulTests,FailedTests,ErrorTests,SkippedTests,TotalTests,PercentageOfSuccessfulTests
2018-04-10,0,0,0,0,0,-1.00
2018-05-09,365,6,0,0,371,98.38
2018-06-08,418,7,3,0,428,97.66
2018-07-07,448,6,3,0,457,98.03
2018-08-07,452,7,3,0,462,97.84
2018-09-07,466,6,3,0,475,98.11
2018-10-08,469,6,3,0,478,98.12
2018-11-22,469,6,3,0,478,98.12
2018-12-28,400,6,0,0,406,98.52
2019-01-28,403,6,0,0,409,98.53
2019-02-27,409,6,0,0,415,98.55
2019-04-09,410,6,0,0,416,98.56
2019-05-10,410,6,0,0,416,98.56
2019-06-11,416,6,0,0,422,98.58
2019-07-26,418,6,1,0,425,98.35
2019-08-30,419,6,1,0,426,98.36
2019-10-07,419,6,1,0,426,98.36
2019-11-06,425,0,1,0,426,99.77
2019-12-05,344,0,1,0,345,99.71
2020-02-18,428,0,1,0,429,99.77
2020-04-14,429,0,1,0,430,99.77
2020-05-15,417,0,1,0,418,99.76
2020-06-22,418,0,1,0,419,99.76
2020-08-01,420,0,1,0,421,99.76
2020-09-24,420,0,1,0,421,99.76
2020-12-09,421,0,1,0,422,99.76
2021-01-07,0,0,0,0,0,-1.00
2021-02-05,422,0,1,0,423,99.76
2021-03-25,422,0,1,0,423,99.76
2021-05-07,422,0,1,0,423,99.76
2021-06-29,427,0,1,0,428,99.77
2021-08-24,427,0,1,0,428,99.77
2021-10-08,434,0,1,0,435,99.77
2021-11-10,435,0,1,0,436,99.77
2021-12-10,437,0,1,0,438,99.77
2022-01-10,452,0,1,0,453,99.78
2022-02-08,454,0,1,0,455,99.78
2022-03-11,459,0,1,0,460,99.78
2022-04-22,483,0,1,0,484,99.79
2022-06-07,484,0,1,0,485,99.79
2022-07-19,487,0,1,0,488,99.80
2022-08-24,380,0,1,0,381,99.74
2022-09-25,381,0,1,0,382,99.74
2022-10-25,381,0,1,0,382,99.74
2022-12-07,383,0,1,0,384,99.74
2023-01-05,383,0,1,0,384,99.74
2023-02-27,383,0,1,0,384,99.74
2023-04-10,385,0,1,0,386,99.74
